5	2	7	1	7	2	1	3	4	3
8	4	8	6	2	6	G	7	2	2
6	4	8	1	2	4	6	6	2	7
6	6	6	1	5	6	4	6	5	3
6	2	8	6	1	3	7	6	6	4
4	3	4	3	8	6	7	6	5	2
5	5	1	2	4	8	6	6	5	8
8	5	3	2	S	2	5	5	8	8
6	5	8	3	8	1	5	3	4	7
6	7	8	8	7	1	2	7	1	2