2	6	6	4	1	7	5	2	6	3
8	7	3	5	7	7	2	5	7	3
4	1	3	6	3	4	1	5	1	4
1	2	8	3	6	3	6	4	2	7
1	3	S	8	5	5	7	1	2	2
6	3	8	5	6	4	7	7	8	4
7	1	7	3	1	8	5	5	1	2
4	6	2	1	7	1	2	1	5	2
1	8	6	4	G	4	8	2	8	6
3	1	6	7	5	8	4	5	4	7