5	8	4	5	3	6	G	5	7	1
5	3	5	2	6	8	4	1	2	6
6	S	7	5	7	2	6	3	2	2
3	8	8	8	3	5	7	4	6	8
4	7	6	7	8	5	8	4	7	1
8	3	6	7	8	4	2	3	6	2
4	6	4	5	8	2	4	4	7	7
4	8	2	4	6	8	8	3	2	1
1	3	5	2	2	6	8	2	1	1
8	2	8	7	5	1	6	7	7	1