6	7	2	3	8	1	7	1	8	7	8	4	5	8	2	8	2	6	7	2
5	5	1	1	8	1	2	8	5	4	3	5	7	2	6	7	7	8	3	7
6	1	1	8	5	3	5	8	3	6	4	1	4	4	5	6	2	4	6	6
1	1	4	6	1	5	5	5	2	4	4	3	3	5	6	7	1	8	5	7
5	7	5	2	4	4	7	1	6	7	5	7	8	8	6	8	6	4	7	5
3	7	7	2	6	3	1	5	6	3	4	5	2	4	8	5	2	2	1	2
2	8	1	7	5	2	4	8	8	5	5	3	4	2	5	1	7	2	4	6
6	2	3	5	5	4	8	3	6	2	4	3	1	5	4	1	8	4	3	7
1	2	5	5	6	8	2	1	8	7	5	3	8	6	2	4	4	3	5	6
8	7	5	8	3	1	3	4	4	5	4	1	1	2	1	5	3	3	1	7
4	8	6	7	7	2	7	8	4	3	4	4	4	4	6	2	1	6	4	4
3	5	6	5	4	5	8	5	6	4	5	6	7	2	7	1	5	2	3	8
2	5	5	3	6	5	5	2	8	3	1	5	6	1	6	4	5	8	4	6
7	6	6	3	5	5	5	1	1	6	8	7	1	2	8	7	7	1	8	6
8	2	7	5	6	8	2	1	2	3	5	3	S	1	4	6	4	8	3	2
2	7	4	7	2	6	3	2	5	1	2	4	7	4	4	5	4	1	5	4
1	1	4	6	5	3	8	1	3	4	1	2	3	1	3	4	4	5	5	3
8	2	6	2	1	7	6	7	4	3	6	3	1	G	4	5	7	8	8	8
5	6	6	5	2	3	6	6	8	2	7	2	8	3	1	6	2	6	2	2
1	2	3	1	8	3	3	5	6	4	4	8	1	3	6	6	6	6	3	7